    NO ./textures/doom/n.xpm

    SO ./textures/doom/s.xpm
WE ./textures/doom/w.xpm
EA    ./textures/doom/e.xpm

  F 20,    20,   20
C 50   ,   50,   50


            11111111111111111111111
           10000000110000000000001
           1011000001110000000000011
           1001000000000000000000001
11111111111100000111000000000000111
10000000001100000111011111111111
11110111111111011100000000001
11110111111111011101010010001
11000000110101011100000010001
10000000000000001100000010001
10000000000000001101010010001
1100000111010101  11D11100E0111
11110111 1110101 100000000001
11111111 1111111 111111111111
11111111111111111111111111111
